NO ./path1
SO ./path2
WE ./path
EA ./path4

F 0,255,0
C 0,0,0



111111
100N01
100001
111111









