


NO ./path1

SO ./path2
WE ./path
EA ./path4

F 22,100,0
C 225,30,0



11111111111
100110100N0111
1111111111111111111111111









