NO ./textures/bluestone.xpm
SO ./textures/greystone.xpm
WE ./textures/redbrick.xpm
EA ./textures/purplestone.xpm

F 0,0,0

C 155,161,157



11111111111111111111
10000000000000000001
10000000000000000001
100000000N0000000001
10000000000000000001
10010001000000000001
10000000000100000001
10000000000011111001
100000000001     101
10000000000111111101
10000000000000000001
10000000000000000001
10000000000000000001
10000000000000000001
10000000000000000001
10000000000000000001
11111111111111111111









