NO ./path1
SO ./path2
WE ./path
EA ./path4

F 0,255,0
C 155,161,157



1111111111
1000000001
1000000001
10000000N1
1000000001
1111111111









