




NO f./path1
SO ./path2
WE ./path
EA ./path4

F 220,100,0
C 225,30,0



1111111111111111111111111
100110000001101
1111111111111111111111111









