


NO ./path1

SO ./path2
WE ./path
EA ./path4

F 255,0,0
C 0,255,255



11111111111
10000000001
100000N0001
10000000001
10000000001
11111111111










