NO ./textures/bluestone.xpm
SO ./textures/greystone.xpm
WE ./textures/redbrick.xpm
EA ./textures/purplestone.xpm

F 0,0,0

C 155,161,157

111111111111111111111
1W0000000000000000001
111111111111111111111