


NO ./path1

SO ./path2
WE ./path
EA ./path4

F 255,0,0
C 0,255,255



11111111111
100110100N0111
1100000000000011
1111111111111111111111111
1111111111111111111111111
11111111111111111111111111111111111111111









