NO ./path1
SO ./path2
WE ./path
EA ./path4

F 0,255,0
C 155,161,157



11111111111111111111
10000000000000000001
10000000000000000001
10000000000000000001
100000000S0000000001
10000000000000000001
10000000000000000001
10000000000000000001
10000000000000000001
10000000000000000001
11111111111111111111









