NO ./path1
SO ./path2
WE ./path
EA ./path4

F 0,255,0
C 155,161,157



11111111111111111111
10000000011111111111
10001000011100000001
10000000N11111111111
10000000011111111111
11111111111111111111









